4
7
5
#######
#. $ .#
# $@$ #
#. $ .#
#######